11111
10001
1E001
10C01
1A0P1
11111
