11111
10001
101C1
101E1
101P1
11111
