11111
10001
1E001
10C01
120P1
11110
