11111
10001
10001E
10C01
100P1
11111
