11111
10001
1E001
10C01
100P1
11111
1