11111
10001
1E001E
10C01
100P1
11111
